af = الأفريكانية
am = الأمهرية
ar = العربية
az = الأذربيجانية
be = البيلاروسية
bg = البلغارية
bn = البنغالية
ca = الكتالونية
ceb = السيبيونو
cs = التشيكية
cy = الويلزية
da = الدنماركية
de = الألمانية
el = اليونانية
en = الإنجليزية
eo = الإسبرانتو
es = الإسبانية
et = الإستونية
fa = الفارسية
fi = الفنلندية
fr = الفرنسية
gl = الجاليكية
gu = الغوجاراتية
he = العبرية
hi = الهندية
hr = الكرواتية
ht = الكريولية الهايتية
hu = الهنغارية
hy = الأرمينية
id = الإندونيسية
is = الآيسلندية
it = الإيطالية
ja = اليابانية
jw = الجاوية
ka = الجورجية
kk = الكازاخستانية
km = الخميرية
kn = الكانادا
ko = الكورية
ku = الكردية
ky = القيرغيزية
la = اللاتينية
lo = اللاوية
lt = الليتوانية
lv = اللاتفية
mg = الملغاشية
mi = الماورية
mk = المقدونية
ml = الماليالامية
mn = المنغولية
mr = الماراثية
ms = الماليزية
mt = المالطية
my = البورمية
ne = النيبالية
nl = الهولندية
no = النرويجية
pa = البنجابية
pl = البولندية
pt = البرتغالية
ro = الرومانية
ru = الروسية
si = السنهالية
sk = السلوفاكية
sl = السلوفينية
so = الصومالية
sq = الألبانية
sr = الصربية
su = السوندانية
sv = السويدية
sw = السواحلية
ta = التاميلية
te = التيلوجو
th = التايلاندية
tl = التاغالوغية
tr = التركية
uk = الأوكرانية
ur = الأردية
uz = الأوزبكية
vi = الفيتنامية
xh = الخوسا
yi = اليديشية
zh-cn = الصينية المبسطة
zh-tw = الصينية التقليدية
zu = الزولو
